{
  "radar": {
    "past": [
      1705320000,
      1705320600,
      1705321200,
      1705321800,
      1705322400,
      1705323000,
      1705323600,
      1705324200,
      1705324800,
      1705325400
    ],
    "nowcast": [
      1705326000,
      1705326600,
      1705327200,
      1705327800,
      1705328400
    ]
  },
  "satellite": {
    "infrared": [
      1705320000,
      1705320600,
      1705321200,
      1705321800,
      1705322400
    ]
  }
}
